########################
#                      #
#                      #
#                      #
#  ##################  #
#      #       #       #
#      #       #       #
#      #   #####       #
#     ###############  #
#      #   #  ##       #
#      #   # ###       #
#      #       #       #
#   #################  #
#                      #
#                      #
########################
