#####################   
#                      #
#                      #
# #########            #
#         #     #      #
#         #     #      #
#    ################# #
#    #    #     #      #
#    #    #     #      #
# ###############      #
#    #    #     #      #
#    #    #     #      #
#    #  ############## #
#               #      #
#                      #
#   ####################
