########################
#                      #
#   ###     ###        #
#                      #
#      ###             #
#                      #
#    #####             #
#                      #
#             ####     #
#                      #
#        ###           #
#                      #
#   ###        ###     #
#                      #
#                      #
########################
