########################
#                      #
#   ###########        #
#   #         #        #
#   #         ######   #
#   #                # #
#   ###########   ## # #
#             #   #  # #
#   ###########   #  # #
#                 #    #
#                      #
########################
