########################
#                      #
#  #######             #
#  #     #             #
#  #     #     ####    #
#  #     #     #  #    #
#  ### ###     #  #    #
#            ###  #    #
#   ######          #  #
#   #    #   ####   #  #
#   #    #   #  #      #
#   ######   #  ####   #
#            #         #
#   #######  #######   #
#                      #
########################
